1111111111111111111
1P00100000000000001
1110101110101111011
1C00010101C00001011
1110101010101011011
1010101000101010001
1010111011111011101
1000000101000000C11
1111100000001011111
1010101000101010101
1110101111001101111
10C0000000001010001
1011111010101111101
1000001010101000101
1011111010111111011
1010101C00000001011
1011111010101111111
1010100010100010001
1111101110111010101
10000001000C00000E1
1111111111111111111
