1111111111111111111111111
1P000000000000000011100C1
1111101110101111011100111
1C00000100C00001011101111
1110101010101011011101111
1010101000101010000000011
1010111011111011100001001
1000000101000000C00000011
1111100000001011110010111
1010101000101010100010011
1110101111001101110111111
10C00000000010100001100C1
1011111010101111101110111
1000001010101000101110111
1011111010111111001110111
1010101C00000001000010011
1011111010101111110000011
101010001010001000011E111
1111101110111010100001111
10000001000C0000000011111
1111111111111111111111111
