11111111111111111111111111111111111111111111111111
1000000000P000000000000000000000000000000000000001
1000000000C0000000000E0000000000000000000000000001
11111111111111111111111111111111111111111111111111
